1111111111111111111111111
1000011000000000000000001
100P00000000E000000001101
1000000001000000000001101
1001110000000000110000001
100001001100C000000110001
1001100000000000000000001
100000011110000000000C001
1111111111111111111111111