1111111111111111111111111
1010011000000000000000001
100C000000001000000001101
10000000111111P0000001101
1001110011100000110000001
1100000000000000000000001
10C110000C0000E0000000001
1000000111100000000000001
1111111111111111111111111