111111111111111111
10000C0000P00E0001
111111111111111111